ACC_DOCUMENT	BAPI	X
ACC_STAT_KEY_FIG	BAPI	X
ACTIVITYTYPE_CREATE	BAPI	X
ACTIVITYTYPEGROUP_CREATE	BAPI	X
ACTIVITYTYPEGROUP_ADDNODE	BAPI	X
BANK_CREATE	BAPI	X
BATMAS	BAPI	X
BOMMAT	BOMM	X
CAP_ACTOUT	BAPI	X
CHRMAS	CHRM	X
CLFMAS	CLFM	X
CLSMAS	CLSM	X
CNPMAS	CNPM	X
COND_A	COND	X
COSMAS	COSM	X
COSTCENTERGROUP_ADDNODE	BAPI	X
COSTCENTERGROUP_CREATE	BAPI	X
COSTTYPE_CREATE	BAPI	X
CREMAS	CRE1	X
DEBMAS	DEBM	X
EQUIPMENT_CREATE	BAPI	X
EXCHANGE_RATE	BAPI	X
FIXEDASSET_CREATEINCLVALUES	BAPI	X
FUNC_LOC_CREATE	BAPI	X
INFREC	INFR	X
INSPECTIONPLAN_CREATE	BAPI	X
INTERNAL_ORDER_CREATE	BAPI	X
KNOMAS	KNOM	X
MATERIALRESERVATION_CREATE1	BAPI	X
MATMAS_MASS_BAPI	BAPI	X
MATQM	BAPI	X
MBGMCR	BAPI	X
PORDCR1	BAPI	X
PREQCR	BAPI	X
PROFITCENTERGROUP_ADDNODE	BAPI	X
PROFITCENTER_CREATE	BAPI	X
PROFITCENTERGROUP_CREATE	BAPI	X
PROJECT	BAPI	X
PURCONTRACT_CREATE	BAPI	X
PURSAG_CREATE	BAPI	X
QPGR	BAPI	X
QPMK	BAPI	X
QSMT	BAPI	X
REFSETOFOPERATIONS_CREATE	BAPI	X
ROUTING_CREATE	BAPI	X
RPLMAS	BAPI	X
SALESORDER_CREATEFROMDAT2	BAPI	X
SERVICE_CREATE	BAPI	X
SHP_OBDLV_CREATE_NOREF	BAPI	X
SRCLST	SRCL	X
ZREQUIREMENTS_CREATE	BAPI	X
